BOOBOOOB - OBBBBBBO
YGYGY - GYG
RBRBBBBR - BRRRRB
OYYYOYYYO - YOOOOOOOOOY
GRRGRG - RGGR

RGGGRRY - GGG
YY - YY
OOYGGGR - GGG
RBBBBRRRGY - BBBB
OOR - OO

BBYYYOYXXXB - YYB
GXXBBGRG - RG
OOOGXXX - OOO
ORGYYXXXX - YGRO
GOX - G

GGGYRORR - GYROR
YBYBYBB - YBYBYB
BB - B
YOO - YO
RORYGRB - RORYGRB

RRRRYGG - RRXXYGG
GGGGGRO - GGGGXRO
OOBRR - XXBRR
RGY - XGY
GGYO - GXYO

GGYYY - YXG
ROOOO - OXXXR
YYYYYR - YXXXXR
RY - RY
OOOBB - OXB

GYOGGYRB - YO
BRYYYRROY - RRO
RORROYBOOO - YB
RGBG - B
GRRGGGRYGG - RY

BGYGBOOOOG - BO
RRRORO - RO
YBBYRGOG - YBG
RRRGGGRRR - R
RGBG - G

BYORXBOGBB - YRGYY
OYYRXBGRRYO - BGRRRY
RGXRGBRGBRGB - GGBGGBGGB
YOOYXOOYYYOY - YYOOOYO
GOXROYYBB - ROYYBB

BXRGGBY - RGGY
OXOORYYBRGB - RYYBRGB
YXRGB - RGB
ROXBYORGBYORG - BYGBYG
RYXBYORGBYORG - BOGBOG

BXROOB - XBORBO
RROBGG - RRBOGG
BYORGG - YBROGG
BXXBRGYR - XBBXGRRY
OORG - OOGR

GYXBYORGBYORG - B
ORXROGBYYBGOR - GBYYBGO
RBXBRBRBR - BR
OYXGBOYYYRBYG - YYYRB
YOXGGYBBYOOY - BBY

BRYOGGRB - YOBRRBGG
YYOGYYOG - OGYYOGYY
BOBRORYY - BRBRYYOR
BYOR - ORBY
GRGRRGGR - GRGRGRRG

BYGGYRO - BYGGYRO
OOYRGYR - OYRG
BOBRORYOYBOB - BRORY
RBGRGB - RBG
GGRYORG - GRYO

XXRRRRXXBXX - XXXXXXRRBXX
XRRRXXXXBXX - XXXXRRRXBXX
XRRRRRXBXXX - XXXXXXRBXXX
XXXXXRRRBXX - XXXXXXXXBXX
XXXRRRRXXBX - XXXXXXXRRBX

XGXXGXGXXX - XGRRGXGXXX
GGXXGXXXXG - GGXXGRRRRG
GGGGXGXXXG - GGGGRGXXXG
XXXXGXGXGG - XXXXGXGRGG
GGXXXGGGXG - GGRRRGGGXG

RGBRGBRXXXGB - GBR
BBXXXXRB - RBBB
XXXYYY - YYY
ROXXXOGO - GOR
BXXXXYBR - YBRB

GGRBXGYOXBBO - GGRBGYOXXBBO
BBOXGRXY - BBOGRXXY
YXYXYY - YXXYYY
RGXOORYGXBOB - RGXXOORYGBOB
BRXYYXY - BRYYXXY

XRGXROXXXBB - RGROBBXXXXX
RXXRRX - XXXRRR
RORXXBO - RORBOXX
XBRYO - XBRYO
RBXXXB - RBBXXX

RGOXBBROGYG - BBGROYO
BYXOYOBRB - OBOYRY
RGBYXYRGB - RGYB
YOXBGR - BGR
GBXGGORY - BBORY

RGOYXBRBO - BGOYBY
RGBXRGB - GBBB
OGXGOGO - GGGG
BYORGXROORB - GRGRGGYORG
BRBXBRBO - RBBBO

XXYGYOXXXX - YOYGYOYGYO
XXRXBYXXXX - BYRXBYRXBY
XRGBX - BRGBR
XXXXXROR - ORRORROR
YXRXXXX - YXRYXRY

RGBXXROXXBB - RGBXXROBBXX
YYXXGGXXBBB - XXYYGGXXBBB
ROOBXXROXXOB - ROOBXXROOBXX
YBXXGYXXO - YBXXGYOXX
OXXOXXRR - XXOOXXRR

